

1111111111111
1C0100000V001
1000011111001
1P0011E000001
1111111111111