1111111111111
1C1100000V001
1110011111001
1P0011E000001
1111111111111