111111111111
1C0100000V00
100001111100
1P0011E00000
111111111111