1111111111111
1C010000V0001
1000V11111001
1P0011E000001
1111111111111