111111111111111111111111111111111
1E000000V000000C00000C00000000001
10100101001000001010010000V010101
111001001010101000100100000010101
1P0000000C00C000000000000V00000C1
111111111111111111111111111111111